10111111111111111111
10100000010000000001
10100000010000000001
10100000010000000001
10100000010000000001
10100000010000000001
10100000010001111111
10111111110001000000
10000100000001000000
11110100000001000000
00010100000001011111
00010100000001010001
00011100000001110001
